{
  "seat_adjacencies": {
    "2": [
      ["A1", "A2"],
      ["A2", "A3"],
      ["A3", "A4"],
      ["A4", "A5"],
      ["A5", "A6"],
      ["A6", "A7"],
      ["A7", "A8"],
      ["A8", "A9"],
      ["B1", "B2"],
      ["B2", "B3"],
      ["B3", "B4"],
      ["B4", "B5"],
      ["B5", "B6"],
      ["B6", "B7"],
      ["C1", "C2"],
      ["C2", "C3"],
      ["C3", "C4"],
      ["C4", "C5"],
      ["D1", "D2"],
      ["E1", "E2"]
    ]
  }
}
